11
8
#.######
#.######
#......#
#.###.##
#..##.##
#.###.##
#.......
#.######
#.##.###
#......#
########
78
55